=== Super Minds 0 ===
[Unit 0]
blue | mÃ u xanh dÆ°Æ¡ng ğŸ”µ
green | mÃ u xanh lÃ¡ ğŸŸ¢
yellow | mÃ u vÃ ng ğŸŸ¡
orange | mÃ u cam ğŸŸ 
red | mÃ u Ä‘á» ğŸ”´
pink | mÃ u há»“ng ğŸ’—
Hello | Xin chÃ o ğŸ‘‹
Bye | Táº¡m biá»‡t ğŸ‘‹
Goodbye | Táº¡m biá»‡t ğŸ‘‹

[Unit 1]
window | cá»­a sá»• ğŸªŸ
chair | cÃ¡i gháº¿ ğŸª‘
book | quyá»ƒn sÃ¡ch ğŸ“–
pencil | bÃºt chÃ¬ âœï¸
table | cÃ¡i bÃ n ğŸª‘
door | cá»­a ra vÃ o ğŸšª
Stand up | Äá»©ng lÃªn â¬†ï¸
Sit down | Ngá»“i xuá»‘ng â¬‡ï¸

[Unit 2]
eyes | Ä‘Ã´i máº¯t ğŸ‘€
ears | Ä‘Ã´i tai ğŸ‘‚
arms | cÃ¡nh tay ğŸ’ª
legs | chÃ¢n ğŸ¦µ
mouth | miá»‡ng ğŸ‘„
nose | mÅ©i ğŸ‘ƒ
head | Ä‘áº§u ğŸ‘¤

[Unit 3]
mum | máº¹ ğŸ‘©
dad | bá»‘ ğŸ‘¨
sister | chá»‹/em gÃ¡i ğŸ‘§
brother | anh/em trai ğŸ‘¦
grandpa | Ã´ng ğŸ‘´
grandma | bÃ  ğŸ‘µ
hen | gÃ  mÃ¡i ğŸ”
dog | con chÃ³ ğŸ¶
duck | con vá»‹t ğŸ¦†
cat | con mÃ¨o ğŸ±
baby | em bÃ© ğŸ‘¶
kitten | mÃ¨o con ğŸ±
puppy | chÃ³ con ğŸ¶
chick | gÃ  con ğŸ¥
duckling | vá»‹t con ğŸ¤

[Unit 4]
parrot | con váº¹t ğŸ¦œ
lion | sÆ° tá»­ ğŸ¦
fish | con cÃ¡ ğŸŸ
zebra | ngá»±a váº±n ğŸ¦“
monkey | con khá»‰ ğŸ’
frog | con áº¿ch ğŸ¸
tree | cÃ¡i cÃ¢y ğŸŒ³
pond | cÃ¡i ao ğŸ’§
big | to ğŸ˜
small | nhá» ğŸ­

[Unit 5]
milk | sá»¯a ğŸ¥›
oranges | nhá»¯ng quáº£ cam ğŸŠ
cakes | nhá»¯ng cÃ¡i bÃ¡nh ngá»t ğŸ°
tomatoes | nhá»¯ng quáº£ cÃ  chua ğŸ…
chocolate | sÃ´-cÃ´-la ğŸ«
pears | nhá»¯ng quáº£ lÃª ğŸ
potatoes | nhá»¯ng cá»§ khoai tÃ¢y ğŸ¥”
carrots | nhá»¯ng cá»§ cÃ  rá»‘t ğŸ¥•
bananas | nhá»¯ng quáº£ chuá»‘i ğŸŒ
ground | máº·t Ä‘áº¥t ğŸŒ
fruit | trÃ¡i cÃ¢y ğŸ
vegetables | rau cá»§ ğŸ¥¦
grow | trá»“ng / má»c ğŸŒ±
come from | Ä‘áº¿n tá»« ğŸ—ºï¸

[Unit 6]
bus stop | tráº¡m xe buÃ½t ğŸš
school | trÆ°á»ng há»c ğŸ«
cinema | ráº¡p chiáº¿u phim ğŸ¬
hospital | bá»‡nh viá»‡n ğŸ¥
toy shop | cá»­a hÃ ng Ä‘á»“ chÆ¡i ğŸ§¸
park | cÃ´ng viÃªn ğŸï¸
cafÃ© | quÃ¡n cÃ  phÃª â˜•
playground | sÃ¢n chÆ¡i ğŸ›
sports centre | trung tÃ¢m thá»ƒ thao âš½
map | báº£n Ä‘á»“ ğŸ—ºï¸

[Unit 7]
teacher | giÃ¡o viÃªn ğŸ‘©ğŸ«
fire fighter | lÃ­nh cá»©u há»a ğŸ‘¨ğŸš’
gardener | ngÆ°á»i lÃ m vÆ°á»n ğŸ‘¨ğŸŒ¾
police officer | cáº£nh sÃ¡t ğŸ‘®
vet | bÃ¡c sÄ© thÃº y ğŸ•
doctor | bÃ¡c sÄ© ğŸ‘¨âš•ï¸
farmer | nÃ´ng dÃ¢n ğŸ‘©ğŸŒ¾
shop assistant | nhÃ¢n viÃªn bÃ¡n hÃ ng ğŸ’
dentist | nha sÄ© ğŸ¦·
inside | bÃªn trong ğŸ 
outside | bÃªn ngoÃ i ğŸŒ³

[Unit 8]
hat | cÃ¡i mÅ© ğŸ§¢
coat | Ã¡o khoÃ¡c ğŸ§¥
scarf | khÄƒn quÃ ng cá»• ğŸ§£
boots | Ä‘Ã´i á»§ng ğŸ‘¢
sweater | Ã¡o len ğŸ§¶
gloves | Ä‘Ã´i gÄƒng tay ğŸ§¤
jeans | quáº§n bÃ² ğŸ‘–
T-shirt | Ã¡o phÃ´ng ğŸ‘•
soft | má»m â˜ï¸
hard | cá»©ng ğŸ’
belt | tháº¯t lÆ°ng ğŸª¢
sunglasses | kÃ­nh rÃ¢m ğŸ•¶ï¸

[Unit 9]
play football | chÆ¡i bÃ³ng Ä‘Ã¡ âš½
run | cháº¡y ğŸƒ
paint a picture | váº½ tranh ğŸ¨
swim | bÆ¡i ğŸŠ
read | Ä‘á»c ğŸ“š
dance | nháº£y mÃºa ğŸ’ƒ
my turn | Ä‘áº¿n lÆ°á»£t tÃ´i ğŸ‘ˆ
sorry | xin lá»—i ğŸ™
guess | Ä‘oÃ¡n ğŸ¤”
slowly | má»™t cÃ¡ch cháº­m rÃ£i ğŸ¢
quickly | má»™t cÃ¡ch nhanh nháº¹n ğŸ‡
hobby | sá»Ÿ thÃ­ch â™Ÿï¸

=== Super Minds 1 ===
[Unit 0]
yellow | mÃ u vÃ ng ğŸŸ¡
red | mÃ u Ä‘á» ğŸ”´
orange | mÃ u cam ğŸŸ 
purple | mÃ u tÃ­m ğŸŸ£
green | mÃ u xanh lÃ¡ ğŸŸ¢
blue | mÃ u xanh dÆ°Æ¡ng ğŸ”µ
bag | cÃ¡i cáº·p / tÃºi ğŸ’
balloon | bÃ³ng bay ğŸˆ
cat | con mÃ¨o ğŸ±
power | sá»©c máº¡nh / nÄƒng lÆ°á»£ng âš¡

[Unit 1]
ruler | thÆ°á»›c káº» ğŸ“
pen | bÃºt má»±c ğŸ–Šï¸
book | quyá»ƒn sÃ¡ch ğŸ“–
rubber | cá»¥c táº©y ğŸ§½
pencil case | há»™p bÃºt ğŸ—‚ï¸
pencil | bÃºt chÃ¬ âœï¸
desk | bÃ n há»c ğŸª‘
notebook | vá»Ÿ ghi chÃ©p ğŸ““
bag | cÃ¡i cáº·p ğŸ’
paper | giáº¥y ğŸ“„

[Unit 2]
computer game | trÃ² chÆ¡i mÃ¡y tÃ­nh ğŸ®
kite | cÃ¡i diá»u ğŸª
plane | mÃ¡y bay âœˆï¸
bike | xe Ä‘áº¡p ğŸš²
doll | bÃºp bÃª ğŸª†
monster | quÃ¡i váº­t ğŸ‘¾
train | tÃ u há»a ğŸš‚
go-kart | xe Ä‘ua nhá» ğŸï¸
car | Ã´ tÃ´ ğŸš—
ball | quáº£ bÃ³ng âš½
big | to ğŸ˜
small | nhá» ğŸ­
old | cÅ© / giÃ  âŒ›
new | má»›i ğŸ†•
long | dÃ i ğŸ“
short | ngáº¯n / tháº¥p ğŸ“
ugly | xáº¥u xÃ­ ğŸ‘¹
beautiful | xinh Ä‘áº¹p ğŸŒ¸

[Unit 3]
donkey | con lá»«a ğŸ´
elephant | con voi ğŸ˜
spider | con nhá»‡n ğŸ•·ï¸
cat | con mÃ¨o ğŸ±
rat | con chuá»™t cá»‘ng ğŸ€
frog | con áº¿ch ğŸ¸
duck | con vá»‹t ğŸ¦†
lizard | tháº±n láº±n ğŸ¦
dog | con chÃ³ ğŸ¶
in | á»Ÿ trong ğŸ“¦
on | á»Ÿ trÃªn ğŸ“
under | á»Ÿ dÆ°á»›i â¬‡ï¸

[Unit 4]
apple | quáº£ tÃ¡o ğŸ
banana | quáº£ chuá»‘i ğŸŒ
cake | bÃ¡nh ngá»t ğŸ°
pizza | bÃ¡nh pizza ğŸ•
sausage | xÃºc xÃ­ch ğŸŒ­
cheese sandwich | bÃ¡nh mÃ¬ káº¹p phÃ´ mai ğŸ¥ª
fish | cÃ¡ ğŸŸ
chicken | thá»‹t gÃ  ğŸ—
peas | Ä‘áº­u hÃ  lan ğŸ«›
steak | bÃ­t táº¿t ğŸ¥©
carrots | cÃ  rá»‘t ğŸ¥•
lunch | bá»¯a trÆ°a ğŸ½ï¸
fridge | tá»§ láº¡nh ğŸ§Š
fruit | trÃ¡i cÃ¢y ğŸ‡
vegetables | rau cá»§ ğŸ¥¦
plant | thá»±c váº­t / cÃ¢y ğŸŒ±
soil | Ä‘áº¥t trá»“ng ğŸº

[Unit 5]
Monday | Thá»© hai ğŸ“…
Tuesday | Thá»© ba ğŸ“…
Wednesday | Thá»© tÆ° ğŸ“…
Thursday | Thá»© nÄƒm ğŸ“…
Friday | Thá»© sÃ¡u ğŸ“…
Saturday | Thá»© báº£y ğŸ“…
Sunday | Chá»§ nháº­t ğŸ“…
go fishing | Ä‘i cÃ¢u cÃ¡ ğŸ£
play football | chÆ¡i bÃ³ng Ä‘Ã¡ âš½
watch TV | xem tivi ğŸ“º
play games | chÆ¡i trÃ² chÆ¡i ğŸ²

[Unit 6]
bedroom | phÃ²ng ngá»§ ğŸ›ï¸
bathroom | phÃ²ng táº¯m ğŸ›
living room | phÃ²ng khÃ¡ch ğŸ›‹ï¸
kitchen | nhÃ  báº¿p ğŸ³
hall | hÃ nh lang / sáº£nh ğŸšª
stairs | cáº§u thang ğŸªœ
cellar | háº§m chá»©a ğŸšï¸
dining room | phÃ²ng Äƒn ğŸ½ï¸

[Unit 7]
sweater | Ã¡o len ğŸ§¶
skirt | vÃ¡y ngáº¯n ğŸ‘—
shorts | quáº§n Ä‘Ã¹i ğŸ©³
trousers | quáº§n dÃ i ğŸ‘–
jacket | Ã¡o khoÃ¡c ğŸ§¥
socks | táº¥t / vá»› ğŸ§¦
jeans | quáº§n bÃ² ğŸ‘–
shoes | giÃ y ğŸ‘
baseball cap | mÅ© lÆ°á»¡i trai ğŸ§¢
T-shirt | Ã¡o phÃ´ng ğŸ‘•

[Unit 8]
arm | cÃ¡nh tay ğŸ’ª
hand | bÃ n tay ğŸ¤š
knee | Ä‘áº§u gá»‘i ğŸ¦µ
fingers | ngÃ³n tay ğŸ‘†
leg | chÃ¢n ğŸ¦µ
foot | bÃ n chÃ¢n (sá»‘ Ã­t) ğŸ¦¶
feet | bÃ n chÃ¢n (sá»‘ nhiá»u) ğŸ¦¶ğŸ¦¶
toes | ngÃ³n chÃ¢n ğŸ‘£
head | Ä‘áº§u ğŸ‘¤

[Unit 9]
paint a picture | váº½ má»™t bá»©c tranh ğŸ¨
listen to music | nghe nháº¡c ğŸ§
catch a fish | báº¯t cÃ¡ ğŸŸ
take a photo | chá»¥p áº£nh ğŸ“¸
eat ice cream | Äƒn kem ğŸ¦
play the guitar | chÆ¡i Ä‘Ã n ghi-ta ğŸ¸
read a book | Ä‘á»c sÃ¡ch ğŸ“–
make a sandcastle | xÃ¢y lÃ¢u Ä‘Ã i cÃ¡t ğŸ–ï¸
look for shells | tÃ¬m vá» sÃ² ğŸš

=== Super Minds 2 ===
[Unit 0]
bookcase | tá»§ sÃ¡ch ğŸ“š
wall | bá»©c tÆ°á»ng ğŸ§±
board | cÃ¡i báº£ng ğŸ“‹
clock | Ä‘á»“ng há»“ treo tÆ°á»ng ğŸ•
door | cá»­a ra vÃ o ğŸšª
cupboard | tá»§ Ä‘á»±ng Ä‘á»“ ğŸ—„ï¸
window | cá»­a sá»• ğŸªŸ
chair | cÃ¡i gháº¿ ğŸª‘
crayon | bÃºt sÃ¡p mÃ u ğŸ–ï¸
floor | sÃ n nha ğŸ 
burglar | káº» trá»™m ğŸ¦¹
drop | lÃ m rÆ¡i ğŸ“¦
quick | nhanh lÃªn âš¡
check out | kiá»ƒm tra / xem thá»­ ğŸ”
Great work | LÃ m tá»‘t láº¯m ğŸ‘
Well done | Giá»i láº¯m ğŸ†

[Unit 1]
get up | thá»©c dáº­y â˜€ï¸
get dressed | máº·c quáº§n Ã¡o ğŸ‘•
have breakfast | Äƒn sÃ¡ng ğŸ
brush your teeth | Ä‘Ã¡nh rÄƒng ğŸª¥
go to school | Ä‘i há»c ğŸ’
have lunch | Äƒn trÆ°a ğŸ¥ª
play in the park | chÆ¡i trong cÃ´ng viÃªn ğŸ›
have dinner | Äƒn tá»‘i ğŸ
go to bed | Ä‘i ngá»§ ğŸ›ï¸
yawn | ngÃ¡p ğŸ˜ª
keys | chÃ¬a khÃ³a ğŸ”‘
bedtime | giá» Ä‘i ngï¿½ ğŸŒ™
bad day | ngÃ y tá»“i tá»‡ ğŸŒ§ï¸
firefighter | lÃ­nh cá»©u há»a ğŸ‘¨ğŸš’
sun | máº·t trá»i â˜€ï¸
shadow | cÃ¡i bÃ³ng ğŸ‘¤

[Unit 2]
polar bear | gáº¥u báº¯c cá»±c ğŸ»â„ï¸
bear | con gáº¥u ğŸ»
zebra | ngá»±a váº±n ğŸ¦“
crocodile | cÃ¡ sáº¥u ğŸŠ
hippo | hÃ  mÃ£ ğŸ¦›
tiger | con há»• ğŸ¯
parrot | con váº¹t ğŸ¦œ
monkey | con khá»‰ ğŸ’
snake | con ráº¯n ğŸ
zoo keeper | ngÆ°á»i trÃ´ng sá»Ÿ thÃº ğŸ¦
throw | nÃ©m ğŸ¤¾
hungry | Ä‘Ã³i bá»¥ng ğŸ½ï¸
peel | bÃ³c vá» ğŸŒ
habitat | mÃ´i trÆ°á»ng sá»‘ng ğŸŒ
grassland | Ä‘á»“ng cá» ğŸŒ¾
ocean | Ä‘áº¡i dÆ°Æ¡ng ğŸŒŠ
polar habitat | mÃ´i trÆ°á»ng vÃ¹ng cá»±c ğŸ”ï¸
rainforest | rá»«ng nhiá»‡t Ä‘á»›i ğŸŒ´

[Unit 3]
train station | ga tÃ u há»a ğŸš‰
hospital | bá»‡nh viá»‡n ğŸ¥
cinema | ráº¡p chiáº¿u phim ğŸ¬
playground | sÃ¢n chÆ¡i ğŸ›
cafÃ© | quÃ¡n cÃ  phÃª â˜•
shop | cá»­a hÃ ng ğŸ›ï¸
street | Ä‘Æ°á»ng phá»‘ ğŸ›£ï¸
bus stop | tráº¡m xe buÃ½t ğŸš
park | cÃ´ng viÃªn ğŸï¸
school | trÆ°á»ng há»c ğŸ«
swimming pool | há»“ bÆ¡i ğŸŠ
town | thá»‹ tráº¥n ğŸ˜ï¸
between | á»Ÿ giá»¯a â†”ï¸
behind | á»Ÿ phÃ­a sau â†©ï¸
in front of | á»Ÿ phÃ­a trÆ°á»›c â†—ï¸
next to | bÃªn cáº¡nh â¡ï¸

[Unit 4]
tomatoes | cÃ  chua ğŸ…
beans | háº¡t Ä‘áº­u ğŸ«˜
greens | rau xanh ğŸ¥¬
potatoes | khoai tÃ¢y ğŸ¥”
kiwis | quáº£ ki-wi ğŸ¥
lemons | quáº£ chanh vÃ ng ğŸ‹
bread | bÃ¡nh mÃ¬ ğŸ
mangos | quáº£ xoÃ i ğŸ¥­
grapes | quáº£ nho ğŸ‡
eggs | trá»©ng ğŸ¥š
watermelons | dÆ°a háº¥u ğŸ‰

[Unit 5]
poster | Ã¡p phÃ­ch ğŸ“°
wardrobe | tá»§ quáº§n Ã¡o ğŸ‘”
mirror | cÃ¡i gÆ°Æ¡ng ğŸª
armchair | gháº¿ bÃ nh ğŸ›‹ï¸
lamp | Ä‘Ã¨n ngá»§ ğŸ’¡
bed | cÃ¡i giÆ°á»ng ğŸ›ï¸
table | cÃ¡i bÃ n ğŸª‘
sofa | gháº¿ sÃ´-pha ğŸ›‹ï¸
rug | táº¥m tháº£m nhá» ğŸ§¶
tidy up | dá»n dáº¹p ğŸ§¹
messy | bá»«a bá»™n ğŸ¤ª
lovely | Ä‘Ã¡ng yÃªu ğŸ˜
comfortable | thoáº£i mÃ¡i ğŸ˜Œ
seat | chá»— ngá»“i ğŸ’º

[Unit 6]
eyes | Ä‘Ã´i máº¯t ğŸ‘€
face | khuÃ´n máº·t ğŸ˜€
glasses | máº¯t kÃ­nh ğŸ‘“
hair | tÃ³c ğŸ’‡
cheeks | mÃ¡ ğŸ˜Š
ears | tai ğŸ‘‚
nose | mÅ©i ğŸ‘ƒ
tears | nÆ°á»›c máº¯t ğŸ˜¢
chin | cáº±m ğŸ¤”
mouth | miá»‡ng ğŸ‘„
sad | buá»“n ğŸ˜”
excited | hÃ o há»©ng ğŸ¤©
scared | sá»£ hÃ£i ğŸ˜¨
tired | má»‡t má»i ğŸ˜´
angry | tá»©c giáº­n ğŸ˜ 
happy | vui váº» ğŸ˜Š
blond | vÃ ng hoe (tÃ³c nam) ğŸ‘±
blonde | vÃ ng hoe (tÃ³c ná»¯) ğŸ‘±â€â™€ï¸
curly | xoÄƒn ğŸŒ€

[Unit 7]
helicopter | trá»±c thÄƒng ğŸš
ship | tÃ u thá»§y lá»›n ğŸš¢
lorry | xe táº£i ğŸš›
boat | thuyá»n ğŸš¤
scooter | xe tay ga / xe trÆ°á»£t ğŸ›´
skateboard | vÃ¡n trÆ°á»£t ğŸ›¹
motorbike | xe mÃ¡y ğŸï¸
taxi | xe táº¯c-xi ğŸš•
bus | xe buÃ½t ğŸšŒ
sail | Ä‘i thuyá»n buá»“m â›µ
drive | lÃ¡i xe (Ã´ tÃ´) ğŸš—
ride | lÃ¡i xe (2 bÃ¡nh) / cÆ°á»¡i ğŸ‡
fly | bay âœˆï¸

[Unit 8]
badminton | cáº§u lÃ´ng ğŸ¸
table tennis | bÃ³ng bÃ n ğŸ“
tennis | quáº§n vá»£t ğŸ¾
basketball | bÃ³ng rá»• ğŸ€
baseball | bÃ³ng chÃ y âš¾
volleyball | bÃ³ng chuyá»n ğŸ
swimming | bÆ¡i lá»™i ğŸŠ
football | bÃ³ng Ä‘Ã¡ âš½
hockey | khÃºc cÃ´n cáº§u ğŸ’
athletics | Ä‘iá»n kinh ğŸƒ
sports club | cÃ¢u láº¡c bá»™ thá»ƒ thao ğŸŸï¸
join | tham gia ğŸ¤
team | Ä‘á»™i ğŸ‘¥
goal | bÃ n tháº¯ng / khung thÃ nh âš½
boring | nhÃ m chÃ¡n ğŸ˜´
fun | vui váº» ğŸ‰
difficult | khÃ³ khÄƒn ğŸ˜°
easy | dá»… dÃ ng ğŸ˜Š

[Unit 9]
read a comic | Ä‘á»c truyá»‡n tranh ğŸ“–
go hiking | Ä‘i bá»™ Ä‘Æ°á»ng dÃ i ğŸ¥¾
visit cousins | thÄƒm anh chá»‹ em há» ğŸ‘¨â€ğŸ‘©â€ğŸ‘§â€ğŸ‘¦
help in the garden | giÃºp lÃ m vÆ°á»n ğŸŒ±
take riding lessons | há»c cÆ°á»¡i ngá»±a ğŸ‡
build a tree house | xÃ¢y nhÃ  trÃªn cÃ¢y ğŸŒ³
keep a scrapbook | lÃ m sá»• lÆ°u niá»‡m ğŸ“”
learn to swim | há»c bÆ¡i ğŸŠ
go camping | Ä‘i cáº¯m tráº¡i ğŸ•ï¸
bake a cake | nÆ°á»›ng bÃ¡nh ğŸ°
rest | nghá»‰ ngÆ¡i ğŸ’¤
have a break | nghá»‰ giáº£i lao â˜•

=== Super Minds 3 ===
[Unit 0]
upstairs | táº§ng trÃªn â¬†ï¸
downstairs | táº§ng dÆ°á»›i â¬‡ï¸
cellar | háº§m chá»©a ğŸšï¸
explorer | nhÃ  thÃ¡m hiá»ƒm ğŸ§­
meet | gáº·p gá»¡ ğŸ¤
lost treasure | kho bÃ¡u tháº¥t láº¡c ğŸ’
museum | báº£o tÃ ng ğŸ›ï¸
adventure | cuá»™c phiÃªu lÆ°u ğŸ—ºï¸
castle | lÃ¢u Ä‘Ã i ğŸ°
secret | bÃ­ máº­t ğŸ¤«
only | duy nháº¥t / chá»‰ 1ï¸âƒ£

[Unit 1]
Art | Má»¹ thuáº­t ğŸ¨
English | Tiáº¿ng Anh ğŸ‡¬ğŸ‡§
Geography | Äá»‹a lÃ½ ğŸŒ
Music | Ã‚m nháº¡c ğŸµ
I.T. | Tin há»c ğŸ’»
History | Lá»‹ch sá»­ ğŸ“œ
Maths | ToÃ¡n â—
Science | Khoa há»c ğŸ”¬
P.E. | Thá»ƒ dá»¥c âš½
in code | báº±ng máº­t mÃ£ ğŸ”
easy | dá»… ğŸ˜Š
keep | giá»¯ ğŸ’¾
dark | tá»‘i tÄƒm ğŸŒ‘
probably | cÃ³ láº½ ğŸ¤”
No way | KhÃ´ng Ä‘á»i nÃ o ğŸ™…
yet | chÆ°a â³
follow | Ä‘i theo ğŸ‘£

[Unit 2]
apple juice | nÆ°á»›c Ã©p tÃ¡o ğŸ§ƒ
cheese | phÃ´ mai ğŸ§€
lemonade | nÆ°á»›c chanh ğŸ‹
salad | sa-lÃ¡t ğŸ¥—
rolls | bÃ¡nh mÃ¬ cuá»™n ğŸ¥–
soup | sÃºp / canh ğŸ²
vegetables | rau cá»§ ğŸ¥¦
water | nÆ°á»›c ğŸ’§
ill | á»‘m / bá»‡nh ğŸ¤’
bite | cáº¯n ğŸ¦·
bit | Ä‘Ã£ cáº¯n (quÃ¡ khá»©) ğŸ¦·
medicine | thuá»‘c ğŸ’Š
hut | tÃºp lá»u ğŸ›–
top | Ä‘á»‰nh â›°ï¸
waterfall | thÃ¡c nÆ°á»›c ğŸŒŠ
golden | báº±ng vÃ ng ğŸ¥‡
get better | há»“i phá»¥c / khá»e hÆ¡n ğŸ’ª
fool | káº» ngá»‘c ğŸ¤¡
Just you wait | HÃ£y Ä‘á»£i Ä‘áº¥y â³

[Unit 3]
wash up | rá»­a bÃ¡t Ä‘Ä©a ğŸ½ï¸
tidy up | dá»n dáº¹p ğŸ§¹
sweep | quÃ©t dá»n ğŸ§¹
cook | náº¥u Äƒn ğŸ‘¨ğŸ³
feed the dog | cho chÃ³ Äƒn ğŸ•
dry the dishes | lau khÃ´ bÃ¡t Ä‘Ä©a ğŸ§½
do the shopping | Ä‘i mua sáº¯m ğŸ›ï¸
take the dog for a walk | dáº¯t chÃ³ Ä‘i dáº¡o ğŸ¦®
tea | trÃ  ğŸ«–
moon | máº·t trÄƒng ğŸŒ™
at night | vÃ o ban Ä‘Ãªm ğŸŒƒ
pilot | phi cÃ´ng âœˆï¸
flight | chuyáº¿n bay âœˆï¸
spaceship | tÃ u vÅ© trá»¥ ğŸš€

[Unit 4]
map | báº£n Ä‘á»“ ğŸ—ºï¸
bank | ngÃ¢n hÃ ng ğŸ¦
bus station | báº¿n xe buÃ½t ğŸšŒ
tower | thÃ¡p ğŸ—¼
library | thÆ° viá»‡n ğŸ“š
market square | quáº£ng trÆ°á»ng chá»£ ğŸ˜ï¸
sports centre | trung tÃ¢m thá»ƒ thao âš½
supermarket | siÃªu thá»‹ ğŸ›’
funfair | há»™i chá»£ vui chÆ¡i ğŸ¡
car park | bÃ£i Ä‘á»— xe ğŸ…¿ï¸
higher than | cao hÆ¡n â¬†ï¸
Pirate Ship | TÃ u cÆ°á»›p biá»ƒn ğŸ´â€â˜ ï¸
the wrong place | nháº§m chá»— âŒ

[Unit 5]
seahorse | cÃ¡ ngá»±a ğŸ 
dolphin | cÃ¡ heo ğŸ¬
seal | háº£i cáº©u ğŸ¦­
shell | vá» sÃ² ğŸš
octopus | báº¡ch tuá»™c ğŸ™
anchor | má» neo âš“
starfish | sao biá»ƒn ğŸŒŸ
turtle | rÃ¹a biá»ƒn ğŸ¢
trap | cÃ¡i báº«y ğŸª¤
chase | Ä‘uá»•i theo ğŸƒâ€â™‚ï¸
giant | khá»•ng loth ğŸ¦
have a look | nhÃ¬n xem ğŸ‘€
get my arm out | rÃºt tay ra ğŸ’ª
stuck | bá»‹ káº¹t ğŸ”’
my beauty | ngÆ°á»i Ä‘áº¹p cá»§a ta ğŸ’ƒ
stupid | ngu ngá»‘c ğŸ¤ª
cage | cÃ¡i lá»“ng ğŸ¦
helpful | hay giÃºp Ä‘á»¡ ğŸ¤
fourth | thá»© tÆ° (sá»‘ thá»© tá»±) 4ï¸âƒ£

[Unit 6]
games console | mÃ¡y chÆ¡i game ğŸ®
electric fan | quáº¡t Ä‘iá»‡n ğŸ’¨
walkie-talkie | bá»™ Ä‘Ã m ğŸ“»
electric toothbrush | bÃ n cháº£i Ä‘iá»‡n ğŸª¥
tablet | mÃ¡y tÃ­nh báº£ng ğŸ“±
torch | Ä‘Ã¨n pin ğŸ”¦
mobile phone | Ä‘iá»‡n thoáº¡i di Ä‘á»™ng ğŸ“±
lift | thang mÃ¡y ğŸ›—
laptop | mÃ¡y tÃ­nh xÃ¡ch tay ğŸ’»
fabulous | tuyá»‡t vá»i ğŸŒŸ
fan | cÃ¡i quáº¡t / ngÆ°á»i hÃ¢m má»™ ğŸ¥°
van | xe táº£i nhá» ğŸš

[Unit 7]
doctor | bÃ¡c sÄ© ğŸ‘¨âš•ï¸
nurse | y tÃ¡ ğŸ‘©âš•ï¸
cold | cáº£m láº¡nh ğŸ¤§
cough | ho ğŸ¤§
headache | Ä‘au Ä‘áº§u ğŸ¤•
toothache | Ä‘au rÄƒng ğŸ¦·
earache | Ä‘au tai ğŸ‘‚
stomach-ache | Ä‘au dáº¡ dÃ y ğŸ¤¢
quietly | má»™t cÃ¡ch yÃªn láº·ng ğŸ¤«
woke up | Ä‘Ã£ thá»©c dáº­y â°
felt | Ä‘Ã£ cáº£m tháº¥y ğŸ¤²
had | Ä‘Ã£ cÃ³ âœ”ï¸
went | Ä‘Ã£ Ä‘i ğŸš¶â€â™‚ï¸
gave | Ä‘Ã£ Ä‘Æ°a cho ğŸ
said | Ä‘Ã£ nÃ³i ğŸ—£ï¸
terrible | khá»§ng khiáº¿p ğŸ˜¨

[Unit 8]
Mexico | nÆ°á»›c MÃª-hi-cÃ´ ğŸ‡²ğŸ‡½
Spain | nÆ°á»›c TÃ¢y Ban Nha ğŸ‡ªğŸ‡¸
Argentina | nÆ°á»›c Ãc-hen-ti-na ğŸ‡¦ğŸ‡·
Egypt | nÆ°á»›c Ai Cáº­p ğŸ‡ªğŸ‡¬
Chile | nÆ°á»›c Chi-lÃª ğŸ‡¨ğŸ‡±
China | nÆ°á»›c Trung Quá»‘c ğŸ‡¨ğŸ‡³
Turkey | nÆ°á»›c Thá»• NhÄ© Ká»³ ğŸ‡¹ğŸ‡·
Brazil | nÆ°á»›c Bra-xin ğŸ‡§ğŸ‡·
Australia | nÆ°á»›c Ãšc ğŸ‡¦ğŸ‡º
India | nÆ°á»›c áº¤n Äá»™ ğŸ‡®ğŸ‡³
North America | Báº¯c Má»¹ ğŸŒ
South America | Nam Má»¹ ğŸŒ
Europe | ChÃ¢u Ã‚u ğŸ‡ªğŸ‡º
Asia | ChÃ¢u Ã ğŸŒ
Africa | ChÃ¢u Phi ğŸŒ
canyon | háº»m nÃºi ğŸï¸
harbour | báº¿n cáº£ng âš“
volcano | nÃºi lá»­a ğŸŒ‹

[Unit 9]
thunderstorm | bÃ£o sáº¥m sÃ©t â›ˆï¸
lightning | tia chá»›p âš¡
rain | mÆ°a ğŸŒ§ï¸
rainy | cÃ³ mÆ°a ğŸŒ§ï¸
wind | giÃ³ ğŸ’¨
windy | cÃ³ gio ğŸ’¨
cloud | mÃ¢y â˜ï¸
cloudy | cÃ³ mÃ¢y â˜ï¸
fog | sÆ°Æ¡ng mÃ¹ ğŸŒ«ï¸
foggy | cÃ³ sÆ°Æ¡ng mÃ¹ ğŸŒ«ï¸
umbrella | cÃ¡i Ã´ â˜‚ï¸
raincoat | Ã¡o mÆ°a ğŸ§¥
boots | Ä‘Ã´i á»§ng ğŸ‘¢
because of | bá»Ÿi vÃ¬ ğŸ§
so much | ráº¥t nhiá»u ğŸ’¯
seaside | bá» biá»ƒn ğŸ–ï¸
steam train | tÃ u hÆ¡i nÆ°á»›c ğŸš‚
crowded | Ä‘Ã´ng Ä‘Ãºc ğŸ‘¥
basket | cÃ¡i giá» ğŸ§º
cart | xe Ä‘áº©y / xe kÃ©o ğŸ›’
wore | Ä‘Ã£ máº·c ğŸ‘—

=== Super Minds 4 ===
[Unit 0]
big wheel | vÃ²ng quay khá»•ng lá»“ ğŸ¡
rollercoaster | tÃ u lÆ°á»£n siÃªu tá»‘c ğŸ¢
roundabout | vÃ²ng quay ngá»±a gá»— / bÃ¹ng binh ğŸ 
mayor | thá»‹ trÆ°á»Ÿng ğŸ‘¨ğŸ’¼
dodgem cars | xe Ä‘iá»‡n Ä‘á»¥ng ğŸï¸
microphone | mi-crÃ´ ğŸ¤
band | ban nháº¡c ğŸ¶
photographer | nhiáº¿p áº£nh gia ğŸ“¸
journalist | nhÃ  bÃ¡o ğŸ“°
well done | lÃ m tá»‘t láº¯m ğŸ‘
try out | thá»­ nghiá»‡m ğŸ§ª
excitement | sá»± pháº¥n khÃ­ch ğŸ¤©
explore | khÃ¡m phÃ¡ ğŸ§­
treasure | kho bÃ¡u ğŸ’
museum | báº£o tÃ ng ğŸ›ï¸

[Unit 1]
queen | ná»¯ hoÃ ng ğŸ‘‘
knight | hiá»‡p s ğŸ¤º
crown | vÆ°Æ¡ng miá»‡n ğŸ‘‘
helmet | mÅ© báº£o hiá»ƒm / mÅ© giÃ¡p â›‘ï¸
necklace | vÃ²ng cá»• ğŸ“¿
bracelet | vÃ²ng tay ğŸ“¿
shield | cÃ¡i khiÃªn ğŸ›¡ï¸
sword | thanh kiáº¿m âš”ï¸
map | báº£n Ä‘á»“ ğŸ—ºï¸
dinosaur | khá»§ng long ğŸ¦–
touch | cháº¡m vÃ o ğŸ‘†
brilliant | xuáº¥t sáº¯c / rá»±c rá»¡ âœ¨
hide | trá»‘n / giáº¥u ğŸ™ˆ
storyteller | ngÆ°á»i ká»ƒ chuyá»‡n ğŸ“–
timeline | dÃ²ng thá»i gian â³

[Unit 2]
mountain | ngá»n nÃºi â›°ï¸
forest | khu rá»«ng ğŸŒ²
village | ngÃ´i lÃ ng ğŸ¡
lake | há»“ nÆ°á»›c ğŸŒŠ
island | hÃ²n Ä‘áº£o ğŸï¸
field | cÃ¡nh Ä‘á»“ ğŸŒ¾
river | dÃ²ng sÃ´ng ğŸŒŠ
path | con Ä‘Æ°á»ng nhá» ğŸ›¤ï¸
picnic | dÃ£ ngoic ğŸ§º
scare | lÃ m sá»£ hÃ£i ğŸ˜¨
rescue | giáº£i cá»©u ğŸš‘
continent | lá»¥c Ä‘á»‹a ğŸŒ
satellite | vá»‡ tinh ğŸ›°ï¸
country | Ä‘áº¥t nÆ°á»›c ğŸ‡»ğŸ‡³
world | tháº¿ giá»›i ğŸŒ

[Unit 3]
fire | ngá»n lá»­a / há»a hoáº¡n ğŸ”¥
flood | lÅ© lá»¥t ğŸŒŠ
emergency services | dá»‹ch vá»¥ kháº©n cáº¥p ğŸš¨
police car | xe cáº£nh sÃ¡t ğŸš“
fire engine | xe cá»©u há»a ğŸš’
ambulance | xe cá»©u thÆ°Æ¡ng ğŸš‘
paramedic | nhÃ¢n viÃªn y táº¿ ğŸ¥
accident | tai náº¡n ğŸš§
hurt | bá»‹ thÆ°Æ¡ng / lÃ m Ä‘au ğŸ¤•
shark | cÃ¡ máº­p ğŸ¦ˆ
extinguisher | bÃ¬nh cá»©u há»a ğŸ§¯
operator | tá»•ng Ä‘Ã i viÃªn ğŸ“
tsunami | sÃ³ng tháº§n ğŸŒŠ
danger | sá»± nguy hiá»ƒm âš ï¸
rescue | giáº£i cá»©u ğŸš‘

[Unit 4]
station | nhÃ  ga ğŸš‰
platform | sÃ¢n ga ğŸ›¤ï¸
escalator | thang cuá»‘n â¬†ï¸
ticket office | phÃ²ng bÃ¡n vÃ© ğŸŸï¸
train driver | ngÆ°á»i lÃ¡i tÃ u ğŸš‚
suitcase | va li ğŸ§³
train track | Ä‘Æ°á»ng ray ğŸ›¤ï¸
return ticket | vÃ© khá»© há»“i ğŸŸï¸
single ticket | vÃ© má»™t chiá»u ğŸŸï¸
tunnel | Ä‘Æ°á»ng háº§ ğŸš‡
disappear | biáº¿n máº¥t ğŸ‘»
conductor | ngÆ°á»i soÃ¡t vÃ© / nháº¡c trÆ°á»Ÿng ğŸ¼
imagination | trÃ­ tÆ°á»Ÿng tÆ°á»£ng ğŸ§ 
eco-friendly | thÃ¢n thiá»‡n vá»›i mÃ´i trÆ°á»ng ğŸŒ±
pollute | gÃ¢y Ã´ nhiá»…m â˜ï¸

[Unit 5]
dark | sáº«m mÃ u / tá»‘i ğŸŒ‘
blonde | vÃ ng hoe ğŸ‘±â€â™€ï¸
fair | sÃ¡ng mÃ u / tráº¯ng tráº»o ğŸ‘±
moustache | ria mÃ©p ğŸ¤¨
curly | xoÄƒn ğŸŒ€
beard | rÃ¢u quai nÃ³n ğŸ§”
scar | váº¿t sáº¹o ğŸ¤•
straight | tháº³ng ğŸ“
criminal | tá»™i pháº¡m ğŸ¦¹
mysterious | bÃ­ áº©n ğŸ•µï¸
uniform | Ä‘á»“ng phá»¥c ğŸ‘®
walkie-talkie | bá»™ Ä‘Ã m ğŸ“»
rob | cÆ°á»›p ğŸ¦¹
sketch | báº£n phÃ¡c tháº£o ğŸ–ï¸
police | cáº£nh sÃ¡t ğŸ‘®

[Unit 6]
tail | cÃ¡i Ä‘uÃ´i ğŸ’
horn | cÃ¡i sá»«ng ğŸ®
scales | váº£y (cÃ¡/rá»“ng) ğŸŸ
wing | Ä‘Ã´i cÃ¡nh ğŸ¦‹
feathers | lÃ´ng vÅ© ğŸª¶
tongue | cÃ¡i lÆ°á»¡i ğŸ‘…
mythical beast | quÃ¡i thÃº huyá»n thoáº¡i ğŸ‰
dinosaur | khá»§ng long ğŸ¦–
mermaid | nÃ ng tiÃªn cÃ¡ ğŸ§œâ€â™€ï¸
unicorn | ká»³ lÃ¢n ğŸ¦„
centaur | nhÃ¢n mÃ£ ğŸ
treasure chest | rÆ°Æ¡ng kho bÃ¡u ğŸ’°
omnivore | Ä‘á»™ng váº­t Äƒn táº¡p ğŸ–ğŸ¥¬
herbivore | Ä‘á»™ng váº­t Äƒn cá» ğŸŒ¿
carnivore | Ä‘á»™ng váº­t Äƒn thá»‹t ğŸ–

[Unit 7]
tambourine | trá»‘ng lá»¥c láº¡c ğŸ””
triangle | káº»ng tam giÃ¡c ğŸ”º
trumpet | kÃ¨n trÃ´m-pÃ©t ğŸº
trombone | kÃ¨n trÃ´m-bÃ´n ğŸ·
drums | trá»‘ng ğŸ¥
harp | Ä‘Ã n háº¡c ğŸ¼
saxophone | kÃ¨n xáº¯c-xÃ´ ğŸ·
violin | Ä‘Ã n vÄ© cáº§m ğŸ»
orchestra | dÃ n nháº¡c ğŸ¼
instrument | nháº¡c cá»¥ ğŸ¸
concert | buá»•i hÃ²a nháº¡c ğŸµ
conductor | nháº¡c trÆ°á»Ÿng ğŸ¼
percussion | bá»™ gÃµ ğŸ¥
string | bá»™ dÃ¢y ğŸ»
wind | bá»™ hÆ¡i (nháº¡c cá»¥) ğŸº

[Unit 8]
planet | hÃ nh tinh ğŸª
rocket | tÃªn lá»­a ğŸš€
UFO | váº­t thá»ƒ bay khÃ´ng xÃ¡c Ä‘á»‹nh ğŸ›¸
star | ngÃ´i sao â­
comet | sao chá»•i â˜„ï¸
telescope | kÃ­nh thiÃªn vÄƒn ğŸ”­
astronaut | phi hÃ nh gia ğŸ‘¨ğŸš€
moon | máº·t trÄƒng ğŸŒ™
space station | tráº¡m vÅ© trá»¥ ğŸ›°ï¸
planetarium | cung thiÃªn vÄƒn ğŸŒŒ
outer space | ngoÃ i vÅ© tr ğŸŒ 
asteroid | tiá»ƒu hÃ nh tinh ğŸŒ‘
orbit | quá»¹ Ä‘áº¡o ğŸ›°ï¸
spacesuit | bá»™ Ä‘á»“ phi hÃ nh gia ğŸ‘¨ğŸš€
universe | vÅ© tr ğŸŒŒ

[Unit 9]
sail a boat | lÃ¡i thuyá»n buá»“m â›µ
swing on a rope | Ä‘u dÃ¢y ğŸª¢
dive into the water | láº·n xuá»‘ng nÆ°á»›c ğŸ¤¿
row a boat | chÃ¨o thuyá»n ğŸ›¶
put up a tent | dá»±ng lá»u â›º
make a fire | Ä‘á»‘t lá»­a ğŸ”¥
collect wood | nháº·t cá»§i ğŸªµ
sleeping bag | tÃºi ngá»§ ğŸ›Œ
tent | cÃ¡i lá»u â›º
campfire | lá»­a tráº¡i ğŸ”¥
campsite | khu cáº¯m tráº¡i ğŸ•ï¸
adventure | cuá»™c phiÃªu lÆ°u ğŸ—ºï¸
holiday | ká»³ nghá»‰ ğŸ–ï¸
nature | thiÃªn nhiÃªn ğŸŒ³
explore | khÃ¡m phÃ¡ ğŸ§­

=== Super Minds 5 ===
[Unit 0]
bubbles | bong bÃ³ng ğŸ«§
explosion | vá»¥ ná»• ğŸ’¥
instructions | hÆ°á»›ng dáº«n ğŸ“
liquid | cháº¥t lá»ng ğŸ’§
goggles | kÃ­nh báº£o há»™ ğŸ¥½
apron | táº¡p dá» ğŸ§¤
powder | bá»™t ğŸ§‚
gloves | gÄƒng tay ğŸ§¤
test tube | á»‘ng nghiá»‡m ğŸ§ª
shelf | cÃ¡i ká»‡ ğŸ“š
science | khoa há»c ğŸ”¬
laboratory | phÃ²ng thÃ­ nghiá»‡m ğŸ§ª
experiment | thÃ­ nghiá»‡m ğŸ§«
safety | sá»± an toÃ n ğŸ›¡ï¸
measure | Ä‘o lÆ°á»ng ğŸ“

[Unit 1]
volcano | nÃºi lá»­a ğŸŒ‹
earthquake | Ä‘á»™ng Ä‘áº¥t ğŸŒ
flood | lÅ© lá»¥t ğŸŒŠ
hurricane | bÃ£o lá»›n / cuá»“ng phong ğŸŒªï¸
tsunami | sÃ³ng tháº§n ğŸŒŠ
forest fire | chÃ¡y rá»«ng ğŸ”¥
smoke | khÃ³i ğŸ’¨
temple | ngÃ´i Ä‘á»n ğŸ›•
statue | bá»©c tÆ°á»£ng ğŸ—¿
fountain | Ä‘Ã i phun nÆ°á»›c â›²
magma | máº¯c-ma (Ä‘Ã¡ nÃ³ng cháº£y trong lÃ²ng Ä‘áº¥t) ğŸŒ‹
lava | dung nham ğŸŒ‹
ash | tro bá»¥i ğŸ’¨
destroy | phÃ¡ há»§y ğŸ’¥
erupt | phun trÃ o ğŸŒ‹

[Unit 2]
rainforest | rá»«ng mÆ°a nhiá»‡t Ä‘á»›i ğŸŒ´
beak | cÃ¡i má» (chim) ğŸ¦
toucan | chim toucan (chim má» to) ğŸ¦œ
sloth | con lÆ°á»i ğŸ¦¥
branch | cÃ nh cÃ¢y ğŸŒ¿
anaconda | trÄƒn anaconda ğŸ
jaguar | bÃ¡o Ä‘á»‘m ğŸ†
anteater | thÃº Äƒn kiáº¿n ğŸ¦
beetle | bá» cÃ¡nh cá»©ng ğŸª²
ecosystem | há»‡ sinh thÃ¡i ğŸŒ¿
oxygen | khÃ­ Ã´-xy ğŸ’¨
species | giá»‘ng loÃ i ğŸ¾
carbon dioxide | khÃ­ cÃ¡c-bÃ´-nÃ­c (CO2) ğŸ’¨
Amazon | rá»«ng A-ma-dÃ´n ğŸŒ³
monkey | con khá»‰ ğŸ’

[Unit 3]
spotlight | Ä‘Ã¨n sÃ¢n kháº¥u / tiÃªu Ä‘iá»ƒm ğŸ’¡
electric guitar | Ä‘Ã n ghi-ta Ä‘iá»‡n ğŸ¸
fans | ngÆ°á»i hÃ¢m má»™ ğŸ¥°
dancer | vÅ© cÃ´ng ğŸ’ƒ
bass guitar | Ä‘Ã n ghi-ta bass ğŸ¸
drum kit | bá»™ trá»‘ng ğŸ¥
stage | sÃ¢n kháº¥u ğŸ­
backing singers | nhÃ³m hÃ¡t bÃ¨ ğŸ¤
bodyguards | vá»‡ sÄ© ğŸ’‚
album | an-bum nháº¡c ğŸ’¿
record | báº£n thu Ã¢m / Ä‘Ä©a hÃ¡t ğŸ’¿
jukebox | mÃ¡y phÃ¡t nháº¡c tá»± Ä‘á»™ng ğŸµ
genre | thá»ƒ loáº¡i ğŸ¶
jazz | nháº¡c jazz ğŸ·
concert | buá»•i hÃ²a nháº¡c ğŸµ

[Unit 4]
waiter | bá»“i bÃ n (nam) ğŸ§‘â€ğŸ³
strawberries | dÃ¢u tÃ¢y ğŸ“
biscuits | bÃ¡nh quy ğŸª
spoon | cÃ¡i thÃ¬a ğŸ¥„
fork | cÃ¡i nÄ©a ğŸ´
knife | con dao ğŸ”ª
chopsticks | Ä‘Ã´i Ä‘Å©a ğŸ¥¢
pepper | háº¡t tiÃªu ğŸŒ¶ï¸
salt | muá»‘i ğŸ§‚
recipe | cÃ´ng thá»©c náº¥u Äƒn ğŸ“œ
ingredients | nguyÃªn liá»‡u ğŸ¥¦
chocolate | sÃ´-cÃ´-la ğŸ«
cacao | ca cao ğŸ«
melt | tan cháº£y ğŸ« 
restaurant | nhÃ  hÃ ng ğŸ½ï¸

[Unit 5]
robbers | nhá»¯ng tÃªn cÆ°á»›p ğŸ¦¹
jail | nhÃ  tÃ¹ ğŸ”’
wagon | xe ngá»±a kÃ©o ğŸ›»
sheriff | cáº£nh sÃ¡t trÆ°á»Ÿng ğŸ¤ 
saddle | yÃªn ngá»±a ğŸ
pistol | sÃºng lá»¥c ğŸ”«
handcuffs | cÃ²ng sá»‘ 8 ğŸ”—
rope | dÃ¢y thá»«ng ğŸª¢
barrel | cÃ¡i thÃ¹ng ğŸ›¢ï¸
Native American | ngÆ°á»i báº£n Ä‘á»‹a Má»¹ (da Ä‘á») ğŸ¹
bison | bÃ² rá»«ng ğŸ‚
tribe | bá»™ láº¡c ğŸ‘¨â€ğŸ‘©â€ğŸ‘§â€ğŸ‘¦
gold rush | cÆ¡n sá»‘t vÃ ng ğŸ†
cowboy | cao bá»“i ğŸ¤ 
arrest | báº¯t giá»¯ ğŸ‘®

[Unit 6]
flag | lÃ¡ cá» ğŸ‡»ğŸ‡³
carpet | táº¥m tháº£m ğŸ§¶
sunglasses | kÃ­nh rÃ¢m ğŸ•¶ï¸
cushion | gá»‘i tá»±a / Ä‘á»‡m ğŸ›‹ï¸
earrings | bÃ´ng tai ğŸ‘‚
souvenir | quÃ  lÆ°u niá»‡m ğŸ
tourist | khÃ¡ch du lá»‹ch ğŸ§³
mosque | nhÃ  thá» Há»“i giÃ¡o ğŸ•Œ
mosaic | tranh kháº£m ğŸ¨
tiles | gáº¡ch men / ngÃ³i ğŸ§±
Istanbul | thÃ nh phá»‘ I-x-tan-bun ğŸ•Œ
Turkey | nÆ°á»›c Thá»• NhÄ© Ká»³ ğŸ‡¹ğŸ‡·
basket | cÃ¡i giá» ğŸ§º
market | chá»£ ğŸ›ï¸
travel | du lá»‹ch ğŸ§­

[Unit 7]
mask | máº·t náº¡ ğŸ­
wig | tÃ³c giÃ¡ ğŸ’‡
actor | diá»…n viÃªn ğŸ­
costume | trang phá»¥c diá»…n ğŸ‘˜
audience | khÃ¡n giáº£ ğŸ‘¥
theatre | nhÃ  hÃ¡t ğŸ­
play | vá»Ÿ ká»‹ch ğŸ¬
Shakespeare | Sáº¿ch-xpia (nhÃ  viáº¿t ká»‹ch) ğŸ“œ
tragedy | bi ká»‹ch ğŸ˜¢
comedy | hÃ i ká»‹ch ğŸ˜„
prop | Ä‘áº¡o cá»¥ ğŸ©
applause | trÃ ng phÃ¡o tay ğŸ‘
stage | sÃ¢n kháº¥u ğŸ­
perform | biá»ƒu diá»…n ğŸ’ƒ
character | nhÃ¢n váº­t ğŸ§‘â€ğŸ¤

[Unit 8]
farmer | nÃ´ng dÃ¢n ğŸ‘©â€ğŸŒ¾
engineer | ká»¹ sÆ° ğŸ‘·
dentist | nha sÄ© ğŸ¦·
artist | há»a sÄ© / nghá»‡ sÄ© ğŸ¨
designer | nhÃ  thiáº¿t káº¿ ğŸ¨
computer programmer | láº­p trÃ¬nh viÃªn mÃ¡y tÃ­nh ğŸ’»
mechanic | thá»£ cÆ¡ khÃ­ ğŸ”§
businesswoman | ná»¯ doanh nhÃ¢n ğŸ‘©â€ğŸ’¼
businessman | nam doanh nhÃ¢n ğŸ‘¨â€ğŸ’¼
cleaner | nhÃ¢n viÃªn vá»‡ sinh ğŸ§¹
future | tÆ°Æ¡ng lai ğŸ”®
career | sá»± nghiá»‡p ğŸ“ˆ
job | cÃ´ng viá»‡c ğŸ’¼
profession | nghá» nghiá»‡p chuyÃªn mÃ´n ğŸ“
skills | ká»¹ nÄƒng ğŸ› ï¸

[Unit 9]
sail | cÃ¡nh buá»“m â›µ
sailor | thá»§y thá»§ ğŸ§‘â€âœˆï¸
captain | thuyá»n trÆ°á»Ÿ ğŸ§‘â€âœˆï¸
mast | cá»™t buá»“m â›µ
lifeboat | thuyá»n cá»©u sinh ğŸš¤
cabin | khoang tÃ u / ca-bin ğŸš¢
porthole | cá»­a sá»• tÃ u thá»§y (trÃ²n) ğŸªŸ
ocean | Ä‘áº¡i dÆ°Æ¡ng ğŸŒŠ
sea | biá»ƒn ğŸŒŠ
ship | tÃ u thá»§y ğŸš¢
voyage | chuyáº¿n háº£i trÃ¬nh ğŸ§­
mystery | bÃ­ áº©n ğŸ•µï¸
adventure | cuá»™c phiÃªu lÆ°u ğŸ—ºï¸
navigation | sá»± Ä‘á»‹nh vá»‹ / nghá» hÃ ng háº£i ğŸ§­
compass | la bÃ n ğŸ§­

=== Super Minds 6 ===
[Back to School]
basketball hoop | rá»• bÃ³ng rá»• ğŸ€
bell | cÃ¡i chuÃ´ng ğŸ””
net | lÆ°á»›i ğŸ•¸ï¸
football pitch | sÃ¢n bÃ³ng Ä‘Ã¡ âš½
running track | Ä‘Æ°á»ng cháº¡y Ä‘iá»n kinh ğŸƒâ€â™‚ï¸
gym | phÃ²ng táº­p thá»ƒ dá»¥c / nhÃ  thi Ä‘áº¥u ğŸ‹ï¸â€â™‚ï¸
tennis court | sÃ¢n quáº§n vá»£t ğŸ¾
bike rack | giÃ¡ Ä‘á»ƒ xe Ä‘áº¡p ğŸš²
railings | hÃ ng rÃ o cháº¯n / lan can ğŸš§
litter bin | thÃ¹ng rÃ¡c ğŸ—‘ï¸
school | trÆ°á»ng há»c ğŸ«
adventure | cuá»™c phiÃªu lÆ°u ğŸ—ºï¸
time travel | du hÃ nh thá»i gian â³
playground | sÃ¢n chÆ¡i ğŸ›
sports | thá»ƒ thao âš½

[Unit 1]
palm tree | cÃ¢y cá» / cÃ¢y dá»«a ğŸŒ´
hook | cÃ¡i mÃ³c ğŸª
eye-patch | miáº¿ng bá»‹t máº¯t ğŸ´â€â˜ ï¸
binoculars | á»‘ng nhÃ²m ğŸ”­
key | chÃ¬a khÃ³a ğŸ”‘
hammock | cÃ¡i vÃµng ğŸª¢
coins | tiá»n xu ğŸ’°
spade | cÃ¡i xáº»ng ğŸªš
treasure chest | rÆ°Æ¡ng kho bÃ¡u ğŸ’°
hole | cÃ¡i há»‘ ğŸ•³ï¸
pirate | cÆ°á»›p biá»ƒn ğŸ´â€â˜ ï¸
anchor | má» neo âš“
bury | chÃ´n giáº¥u âš°ï¸
rob | cÆ°á»›p ğŸ¦¹
steal | trá»™m cáº¯p ğŸ¦¹

[Unit 2]
hang-glider | diá»u lÆ°á»£n ğŸª‚
parachute | cÃ¡i dÃ¹ ğŸª‚
monorail | tÃ u Ä‘Æ°á»ng ray Ä‘Æ¡n ğŸš
solar panel | táº¥m pin nÄƒng lÆ°á»£ng máº·t trá»i â˜€ï¸
microlight | mÃ¡y bay siÃªu nháº¹ âœˆï¸
wind turbine | tua bin giÃ³ ğŸ’¨
cable car | cÃ¡p treo ğŸš 
jet pack | ba lÃ´ pháº£n lá»±c ğŸš€
surfboard | vÃ¡n lÆ°á»›t sÃ³ng ğŸ„â€â™‚ï¸
inline skates | giÃ y trÆ°á»£t pa-tin (bÃ¡nh dá»c) ğŸ›¼
unicycle | xe Ä‘áº¡p má»™t bÃ¡nh ğŸš²
future | tÆ°Æ¡ng lai ğŸ”®
transport | giao thÃ´ng / váº­n táº£i ğŸš—
pollute | gÃ¢y Ã´ nhiá»…m â˜ï¸
driverless | khÃ´ng ngÆ°á»i lÃ¡i ğŸ¤–

[Unit 3]
Sphinx | tÆ°á»£ng NhÃ¢n sÆ° ğŸ—¿
pharaoh | pharaoh / vua Ai Cáº­p cá»• ğŸ‘‘
pyramid | kim tá»± thÃ¡p ğŸ—¿
chariot | xe chiáº¿n mÃ£ ğŸ
hieroglyphics | chá»¯ tÆ°á»£ng hÃ¬nh ğŸ”¤
mummy | xÃ¡c Æ°á»›p âš°ï¸
tomb | lÄƒng má»™ âš°ï¸
Egypt | Ai Cáº­p ğŸ‡ªğŸ‡¬
slaves | nÃ´ lá»‡ ğŸ”—
archaeologist | nhÃ  kháº£o cá»• há»c ğŸ§­
mystery | bÃ­ áº©n ğŸ•µï¸
UFO | váº­t thá»ƒ bay khÃ´ng xÃ¡c Ä‘á»‹nh ğŸ›¸
restore | phá»¥c há»“i / trÃ¹ng tu ğŸ›ï¸
civilisation | ná»n vÄƒn minh ğŸ›ï¸
BC | trÆ°á»›c CÃ´ng nguyÃªn â³

[Unit 4]
Olympics | Tháº¿ váº­n há»™i ğŸ…
long jump | nháº£y xa ğŸ¦˜
hurdles | cháº¡y vÆ°á»£t rÃ o ğŸƒâ€â™‚ï¸
high jump | nháº£y cao ğŸ¦˜
boxing | quyá»n anh ğŸ¥Š
archery | báº¯n cung ğŸ¹
wrestling | Ä‘áº¥u váº­t ğŸ¤¼â€â™‚ï¸
weightlifting | cá»­ táº¡ ğŸ‹ï¸â€â™‚ï¸
rowing | chÃ¨o thuyá»n ğŸš£â€â™‚ï¸
gymnastics | thá»ƒ dá»¥c dá»¥ng cá»¥ ğŸ¤¸â€â™‚ï¸
fencing | Ä‘áº¥u kiáº¿m ğŸ¤º
athlete | váº­n Ä‘á»™ng viÃªn ğŸƒâ€â™‚ï¸
compete | thi Ä‘áº¥u ğŸ†
stadium | sÃ¢n váº­n Ä‘á»™ng ğŸŸï¸
medal | huy chÆ°Æ¡ng ğŸ…

[Unit 5]
carpenter's | xÆ°á»Ÿng má»™c ğŸªš
jeweller's | tiá»‡m kim hoÃ n ğŸ’
butcher's | cá»­a hÃ ng thá»‹t ğŸ¥©
grocer's | cá»­a hÃ ng táº¡p hÃ³a ğŸ›’
baker's | tiá»‡m bÃ¡nh mÃ¬ ğŸ
barber's | tiá»‡m cáº¯t tÃ³c (nam) ğŸ’‡â€â™‚ï¸
tailor's | tiá»‡m may ğŸ‘•
chemist's | hiá»‡u thuá»‘c ğŸ’Š
London | LuÃ¢n ÄÃ´n ğŸ‡¬ğŸ‡§
shop | cá»­a hÃ ng ğŸ›ï¸
stunt | pha máº¡o hiá»ƒm / Ä‘Ã³ng tháº¿ ğŸ¤¸â€â™‚ï¸
rescue | giáº£i cá»©u ğŸš‘
square | quáº£ng trÆ°á»ng ğŸ›ï¸
pop | nháº¡c pop / tiáº¿ng ná»• bá»‘p ğŸµ
market | chá»£ ğŸ›ï¸

[Unit 6]
screwdriver | tua vÃ­t ğŸ”©
hammer | cÃ¡i bÃºa ğŸ”¨
drill | mÃ¡y khoan ğŸ› ï¸
saw | cÃ¡i cÆ°a ğŸªš
lever | Ä‘Ã²n báº©y ğŸ› ï¸
spanner | cá» lÃª ğŸ”§
paintbrush | cá» sÆ¡n ğŸ–Œï¸
button | cÃ¡i nÃºt / khuy Ã¡o ğŸ§¥
switch | cÃ´ng táº¯c ğŸ”Œ
nails | cÃ¡i Ä‘inh ğŸ”©
inventor | nhÃ  phÃ¡t minh ğŸ§ª
invent | phÃ¡t minh ğŸ’¡
invention | phÃ¡t minh / sÃ¡ng cháº¿ ğŸ’¡
tool | dá»¥ng cá»¥ ğŸ› ï¸
machine | mÃ¡y mÃ³c âš™ï¸

[Unit 7]
countdown clock | Ä‘á»“ng há»“ Ä‘áº¿m ngÆ°á»£c â°
lunar module | mÃ´-Ä‘un máº·t trÄƒng (tÃ u Ä‘á»• bá»™) ğŸš€
space capsule | khoang tÃ u vÅ© tr ğŸš€
spacesuit | bá»™ Ä‘á»“ phi hÃ nh gia ğŸ‘¨ğŸš€
launch pad | bá»‡ phÃ³ng ğŸš€
crater | miá»‡ng nÃºi lá»­a / há»‘ va cháº¡m ğŸŒ‘
control panel | báº£ng Ä‘iá»u khiá»ƒn ğŸ›ï¸
headset | tai nghe (kÃ¨m mic) ğŸ§
screen | mÃ n hÃ¬nh ğŸ“º
moon | máº·t trÄƒng ğŸŒ™
astronaut | phi hÃ nh gia ğŸ‘¨ğŸš€
mission | nhiá»‡m vá»¥ / sá»© má»‡nh ğŸ¯
space | vÅ© trá»¥ / khÃ´ng gian ğŸŒŒ
NASA | cÆ¡ quan hÃ ng khÃ´ng vÅ© trá»¥ Má»¹ ğŸš€
Houston | trung tÃ¢m Ä‘iá»u khiá»ƒn (thÃ nh phá»‘ Houston) ğŸ›°ï¸

[Unit 8]
Northern Lights | Báº¯c cá»±c quang ğŸŒŒ
iceberg | táº£ng bÄƒng trÃ´i ğŸ§Š
polar bear | gáº¥u báº¯c cá»±c ğŸ»â„ï¸
ice floe | táº£ng bÄƒng ná»•i ğŸ§Š
seal | háº£i cáº©u ğŸ¦­
igloo | lá»u tuyáº¿t ğŸ›–
mittens | gÄƒng tay há»Ÿ ngÃ³n (gÄƒng tay len) ğŸ§¤
sledge | xe trÆ°á»£t tuyáº¿t ğŸ›·
Arctic | Báº¯c cá»±c ğŸ§Š
North Pole | Cá»±c Báº¯c ğŸ§­
freezing | Ä‘Ã³ng bÄƒng / láº¡nh cÃ³ng ğŸ¥¶
aurora borealis | báº¯c cá»±c quang (tÃªn khoa há»c) ğŸŒŒ
cold | láº¡nh â„ï¸
snow | tuyáº¿t â„ï¸
ice | bÄƒng ğŸ§Š

[Unit 9]
sunrise | bÃ¬nh minh ğŸŒ…
horizon | Ä‘Æ°á»ng chÃ¢n trá»i ğŸŒ…
pond | cÃ¡i ao ğŸ’§
grassland | Ä‘á»“ng cá» ğŸŒ¾
valley | thung lÅ©ng ğŸï¸
bush | bá»¥i cÃ¢y ğŸŒ¿
stream | dÃ²ng suá»‘i ğŸ’§
swamp | Ä‘áº§m láº§y ğŸŒŠ
dinosaur | khá»§ng long ğŸ¦–
Jurassic | ká»· Jura ğŸ¦•
T-rex | khá»§ng long báº¡o chÃºa ğŸ¦–
triceratops | khá»§ng long ba sá»«ng ğŸ¦•
meadow | Ä‘á»“ng cá» (thÆ°á»ng cÃ³ hoa) ğŸŒ¼
nature | thiÃªn nhiÃªn ğŸŒ³
extinct | tuyá»‡t chá»§ng ğŸª¦

=== Open world A2 ===
[Starter Unit: Who I am]
Nationality | Quá»‘c tá»‹ch ğŸ‡ºğŸ‡³
Relative | Há» hÃ ng ğŸ‘¨â€ğŸ‘©â€ğŸ‘§â€ğŸ‘¦
Grandparent | Ã”ng bÃ  ğŸ‘µğŸ‘´
Nephew | ChÃ¡u trai (con cá»§a anh/chá»‹/em) ğŸ‘¦
Niece | ChÃ¡u gÃ¡i (con cá»§a anh/chá»‹/em) ğŸ‘§
Cousin | Anh chá»‹ em há» ğŸ‘«
Surname | Há» ğŸ“
Identity card | Chá»©ng minh nhÃ¢n dÃ¢n/Tháº» cÄƒn cÆ°á»›c ğŸªª
Passport | Há»™ chiáº¿u ğŸ“˜
Address | Äá»‹a chá»‰ ğŸ 

[Unit 1: A busy life]
Spend time alone | DÃ nh thá»i gian má»™t mÃ¬nh ğŸ§˜
Go shopping | Äi mua sáº¯m ğŸ›ï¸
Relax at home | ThÆ° giÃ£n táº¡i nhÃ  ğŸ›‹ï¸
Mechanic | Thá»£ mÃ¡y ğŸ”§
Photographer | Nhiáº¿p áº£nh gia ğŸ“¸
Pilot | Phi cÃ´ng âœˆï¸
Police officer | Cáº£nh sÃ¡t ğŸ‘®
Waitress | Ná»¯ bá»“i bÃ n ğŸ‘©â€ğŸ³
Uniform | Äá»“ng phá»¥c ğŸ‘”
Get dressed | Máº·c quáº§n Ã¡o ğŸ‘•
Wake up | Thá»©c dáº­y â°
Leave the house | Rá»i khá»i nhÃ  ğŸšª

[Unit 2: Changing world]
Autumn | MÃ¹a thu ğŸ‚
Spring | MÃ¹a xuÃ¢n ğŸŒ¸
Summer | MÃ¹a hÃ¨ â˜€ï¸
Winter | MÃ¹a Ä‘Ã´ng â„ï¸
Cloudy | Nhiá»u mÃ¢y â˜ï¸
Foggy | CÃ³ sÆ°Æ¡ng mÃ¹ ğŸŒ«ï¸
Freezing | Ráº¥t láº¡nh/Ä‘Ã´ng cá»©ng ğŸ¥¶
Stormy | CÃ³ bÃ£o â›ˆï¸
Temperature | Nhiá»‡t Ä‘á»™ ğŸŒ¡ï¸
Mountain | NÃºi â›°ï¸
Waterfall | ThÃ¡c nÆ°á»›c ğŸŒŠ
Coast | Bá» biá»ƒn ğŸ–ï¸

[Unit 3: Free time, screen time?]
Social media | Máº¡ng xÃ£ há»™i ğŸ“±
Video games | TrÃ² chÆ¡i Ä‘iá»‡n tá»­ ğŸ®
Download | Táº£i xuá»‘ng â¬‡ï¸
Stream | PhÃ¡t trá»±c tuyáº¿n ğŸ“º
Science fiction | Khoa há»c viá»…n tÆ°á»Ÿng ğŸš€
Horror | Phim kinh dá»‹ ğŸ‘»
Comedy | Phim hÃ i ğŸ˜‚
Documentary | Phim tÃ i liá»‡u ğŸ¬
Blogger | NgÆ°á»i viáº¿t blog âœï¸
Episode | Táº­p (phim) ğŸ“º
Series | Phim bá»™ ğŸï¸
Competition | Cuá»™c thi ğŸ†

[Unit 4: Keep fit, feel good]
Heart | TrÃ¡i tim â¤ï¸
Stomach | Dáº¡ dÃ y ğŸ¤°
Brain | NÃ£o bá»™ ğŸ§ 
Headache | Äau Ä‘áº§u ğŸ¤•
Toothache | Äau rÄƒng ğŸ¦·
Backache | Äau lÆ°ng ğŸ§
Sore throat | Äau há»ng ğŸ—£ï¸
Painkillers | Thuá»‘c giáº£m Ä‘au ğŸ’Š
Prescription | ÄÆ¡n thuá»‘c ğŸ“
Ambulance | Xe cá»©u thÆ°Æ¡ng ğŸš‘
Appointment | Cuá»™c háº¹n (vá»›i bÃ¡c sÄ©) ğŸ“…

[Unit 5: More than a holiday]
Destination | Äiá»ƒm Ä‘áº¿n ğŸ—ºï¸
Accommodation | Chá»— á»Ÿ ğŸ¨
Tour guide | HÆ°á»›ng dáº«n viÃªn du lá»‹ch ğŸ§­
Luggage | HÃ nh lÃ½ ğŸ§³
Suitcase | Vali ğŸ§³
Backpack | Ba lÃ´ ğŸ’
Delay | TrÃ¬ hoÃ£n â³
Sightseeing | Tham quan ğŸ›ï¸
Hop-on / hop-off bus | Xe buÃ½t du lá»‹ch lÃªn xuá»‘ng tá»± do ğŸšŒ
Discount | Giáº£m giÃ¡ ğŸ’°
Souvenir | QuÃ  lÆ°u niá»‡m ğŸ

[Unit 6: Time for food]
Omelette | Trá»©ng cuá»™n ğŸ³
Cereal | NgÅ© cá»‘c ğŸ¥£
Yoghurt | Sá»¯a chua ğŸ¥›
Chilli | á»št ğŸŒ¶ï¸
Curry | CÃ  ri ğŸ›
Peel | Gá»t vá» ğŸŒ
Chop | BÄƒm/thÃ¡i nhá» ğŸ”ª
Fry | ChiÃªn/rÃ¡n ğŸ³
Grill | NÆ°á»›ng (báº±ng vá»‰) ğŸ¥“
Steam | Háº¥p ğŸ¥˜
Table service | Phá»¥c vá»¥ táº¡i bÃ n ğŸ½ï¸
Generous portion | Kháº©u pháº§n Äƒn háº­u hÄ©nh ğŸ—

[Unit 7: Live life!]
Baking | NÆ°á»›ng bÃ¡nh ğŸ°
Gig | Buá»•i biá»ƒu diá»…n Ã¢m nháº¡c ğŸ¤
Photography | Nhiáº¿p áº£nh ğŸ“¸
Audience | KhÃ¡n giáº£ ğŸ‘¥
Rehearsal | Buá»•i tá»•ng duyá»‡t ğŸ­
Costume | Trang phá»¥c biá»ƒu diá»…n ğŸ‘—
Stage | SÃ¢n kháº¥u ğŸª
Songwriter | NgÆ°á»i sÃ¡ng tÃ¡c bÃ i hÃ¡t ğŸµ
Guitarist | NgÆ°á»i chÆ¡i ghi-ta ğŸ¸
Drummer | NgÆ°á»i chÆ¡i trá»‘ng ğŸ¥
Leaflet | Tá» rÆ¡i ğŸ“„
Festival | Lá»… há»™i ğŸ‰

[Unit 8: Feels like home]
Cottage | NhÃ  tranh/nhÃ  nhá» á»Ÿ nÃ´ng thÃ´n ğŸ¡
Houseboat | NhÃ  thuyá»n ğŸ›¶
Villa | Biá»‡t thá»± ğŸ°
Balcony | Ban cÃ´ng ğŸŒ¿
Basement | Táº§ng háº§m ğŸšï¸
Garage | NhÃ  Ä‘á»ƒ xe ğŸš—
Rent | ThuÃª/Tiá»n thuÃª nhÃ  ğŸ’°
Neighbour | HÃ ng xÃ³m ğŸ‘¨â€ğŸ‘©â€ğŸ‘§â€ğŸ‘¦
Sink | Bá»“n rá»­a ğŸš°
Cooker | Báº¿p náº¥u ğŸ³
Fridge | Tá»§ láº¡nh ğŸ§Š
Cupboard | Tá»§ cháº¡n/tá»§ chÃ©n ğŸ—„ï¸

[Unit 9: Getting along]
Confident | Tá»± tin ğŸ’ª
Shy | NhÃºt nhÃ¡t ğŸ˜³
Reliable | ÄÃ¡ng tin cáº­y ğŸ¤
Generous | Rá»™ng lÆ°á»£ng ğŸ¤²
Worried | Lo láº¯ng ğŸ˜Ÿ
Stressed | CÄƒng tháº³ng ğŸ˜«
Bad mood | TÃ¢m tráº¡ng tá»“i tá»‡ ğŸ˜ 
Argue | Tranh cÃ£i ğŸ—£ï¸
Get on well | HÃ²a thuáº­n vá»›i nhau â˜ºï¸
Enroll | ÄÄƒng kÃ½ há»c ğŸ“
Volunteer work | CÃ´ng viá»‡c tÃ¬nh nguyá»‡n ğŸ¤

[Unit 10: Out and about]
Statue | Bá»©c tÆ°á»£ng ğŸ—¿
Fountain | ÄÃ i phun nÆ°á»›c â›²
Stadium | SÃ¢n váº­n Ä‘á»™ng ğŸŸï¸
Castle | LÃ¢u Ä‘Ã i ğŸ°
Roundabout | VÃ²ng xuyáº¿n ğŸš¦
Crossing | Váº¡ch sang Ä‘Æ°á»ng ğŸš¶â€â™‚ï¸
Traffic lights | ÄÃ¨n giao thÃ´ng ğŸš¥
Pedestrian | NgÆ°á»i Ä‘i bá»™ ğŸš¶
Pavement | Vá»‰a hÃ¨ ğŸ›£ï¸
Skyscraper | TÃ²a nhÃ  chá»c trá»i ğŸ™ï¸
Square | Quáº£ng trÆ°á»ng ğŸ›ï¸

[Unit 11: Saving and spending]
Salary | Tiá»n lÆ°Æ¡ng ğŸ’µ
Discount | Chiáº¿t kháº¥u/Giáº£m giÃ¡ ğŸ’°
Receipt | HÃ³a Ä‘Æ¡n/BiÃªn lai ğŸ§¾
Bill | HÃ³a Ä‘Æ¡n thanh toÃ¡n ğŸ’¸
Earn | Kiáº¿m tiá»n ğŸ’¼
Borrow | MÆ°á»£n ğŸ¤²
Waste | LÃ£ng phÃ­ ğŸ—‘ï¸
Changing room | PhÃ²ng thay Ä‘á»“ ğŸ›‹ï¸
Shop assistant | NhÃ¢n viÃªn bÃ¡n hÃ ng ğŸ’
Cash | Tiá»n máº·t ğŸ’µ
Credit card | Tháº» tÃ­n dá»¥ng ğŸ’³
Currency | Tiá»n tá»‡ ğŸ’±

[Unit 12: Through life]
Biology | Sinh há»c ğŸ§¬
Chemistry | HÃ³a há»c ğŸ§ª
Physics | Váº­t lÃ½ âš›ï¸
Experiment | ThÃ­ nghiá»‡m ğŸ”¬
Essay | BÃ i tiá»ƒu luáº­n ğŸ“
Degree | Báº±ng cáº¥p (Äáº¡i há»c) ğŸ“
Qualification | Báº±ng cáº¥p/Chá»©ng chá»‰ ğŸ“œ
Diploma | Báº±ng cáº¥p ğŸ“„
CV (Curriculum Vitae) | SÆ¡ yáº¿u lÃ½ lá»‹ch ğŸ“„
Boss | Sáº¿p/Chá»§ ğŸ‘¨â€ğŸ’¼
Staff | NhÃ¢n viÃªn ğŸ‘¥

[Unit 13: About me]
Sociable | HÃ²a Ä‘á»“ng ğŸ˜Š
Kind | Tá»­ táº¿ ğŸ¤—
Brilliant | Ráº¥t thÃ´ng minh/tÃ i giá»i ğŸŒŸ
Clever | ThÃ´ng minh ğŸ§ 
Lazy | LÆ°á»i biáº¿ng ğŸ˜´
Serious | NghiÃªm tÃºc ğŸ§
Handbag | TÃºi xÃ¡ch ğŸ‘œ
Jewellery | Äá»“ trang sá»©c ğŸ’
Sandals | DÃ©p xÄƒng Ä‘an ğŸ‘¡
Tie | CÃ  váº¡t ğŸ‘”
Trainers | GiÃ y thá»ƒ thao ğŸ‘Ÿ
Fashionable | Há»£p thá»i trang ğŸ‘—

[Unit 14: Play it, watch it, love it]
Athletics | Äiá»n kinh ğŸƒâ€â™‚ï¸
Rugby | BÃ³ng báº§u dá»¥c ğŸ‰
Net | LÆ°á»›i ğŸ•¸ï¸
Racket | Vá»£t ğŸ¾
Goal | Khung thÃ nh/BÃ n tháº¯ng âš½
Match | Tráº­n Ä‘áº¥u ğŸ¤¼
Pitch | SÃ¢n cá» (bÃ³ng Ä‘Ã¡) âš½
Referee | Trá»ng tÃ i ğŸ‘¨â€âš–ï¸
Tournament | Giáº£i Ä‘áº¥u ğŸ†
Afterwards | Sau Ä‘Ã³ â­ï¸
Surprisingly | ÄÃ¡ng ngáº¡c nhiÃªn ğŸ˜²
Luckily | May máº¯n thay ğŸ€
